wwwwwwwwwwwwwwwwwwwwwwwwwwwwwwwwwww
w                                 w
w                                 w
w                                 w
w                                 w
w                                 w
w           v              p      w
w                                 w  f
w                                 w
w                                 w
w                                 w
w                                fw
wwwwwwwwwwwwwwwwwwwwwwwwwwwwwwwwwww