wwwwwwwwwwwwwwwwwwwwwwwwwwwwwwwwwww
w                                 w
w                                 w
w                                 w
w                                 w
w                                 w
w           b              p      w
w                                 w  f
w                                 w
w                                 w
w                                 w
w                                fw
wwwwwwwwwwwwwwwwwwwwwwwwwwwwwwwwwww