wwwwwwwwwwwwwwwwwwwwwwwwwwwwwwwwwww
w                                 w
w                                 w
w    r                            w
w          o                      w
w                                 w
w     v     b              p      w
w                                 w  f
w                                 w
w                                 w
w                                 w
w                                fw
wwwwwwwwwwwwwwwwwwwwwwwwwwwwwwwwwww